──┬───────┬───────┬───────────┬───┬───────┐
  │       │       │           │   │       │
│ └───┐ ──┘ │ ────┤ ┌───┐ │ ┌─┘ │ │ ┌───┐ │
│     │     │     │ │   │ │ │   │   │   │ │
├───┐ └─────┤ ┌─┐ │ │ ┌─┘ ├─┘ ┌─┴───┘ │ │ │
│   │       │ │ │   │ │   │   │       │ │ │
│ │ └─┬─┬── │ │ └───┘ │ │ │ ┌─┴── ┌───┴─┤ │
│ │   │ │   │         │ │ │ │     │     │ │
│ │ │ │ │ ┌─┴───┬───┐ │ │ │ │ │ ┌─┘ ┌─┐ │ │
│ │ │   │ │     │   │ │ │ │   │ │   │ │   │
│ │ └─┐ │ │ ┌─┐ │ ──┘ │ └─┤ ┌─┴─┘ ┌─┤ └── │
│ │   │ │   │ │ │     │   │ │     │ │     │
│ └─┐ └─┴───┤ │ │ ──┬─┴─┐ │ │ ┌───┘ │ ────┤
│   │       │   │   │   │   │ │     │     │
├───┴── ┌───┘ ┌─┴───┘ │ └───┘ ├── │ └───┐ │
│       │     │       │       │   │     │ │
│ ┌───┬─┘ ┌───┴─┐ ┌───┼─────┬─┘ ┌─┴───┬─┘ │
│ │   │   │     │ │   │     │   │     │   │
│ │ │ │ ──┘ ┌── │ │ │ │ │ ──┘ │ │ ──┐ │ ──┘
│   │       │     │ │   │     │     │     
└───┴───────┴─────┴─┴───┴─────┴─────┴──────