────┬─────┬───────────────┬───────┬─────┬─┐
    │     │               │       │     │ │
┌── │ │ ──┘ ──┬──── ┌──── │ ┌───┐ │ │ │ │ │
│   │ │       │     │       │   │ │ │ │ │ │
│ ──┴─┼───────┘ ┌───┴─────┬─┘ │ │ └─┘ │ │ │
│     │         │         │   │ │     │   │
├─┬── │ ┌─────┬─┘ ┌─────┐ │ ──┼─┴───┬─┼── │
│ │   │ │     │   │     │ │   │     │ │   │
│ │ ──┤ │ ──┐ │ ──┴── │ │ │ │ │ │ │ │ │ ──┤
│ │   │ │   │         │ │ │ │ │ │ │   │   │
│ └─┐ │ └── ├───────┬─┴─┘ ├─┘ │ │ ├───┴─┐ │
│   │ │     │       │     │   │ │ │     │ │
│ ──┘ │ ──┬─┘ ┌───┐ │ ┌───┘ ──┘ │ │ │ ┌─┘ │
│     │   │   │   │ │ │         │ │ │ │   │
│ ┌───┴─┐ │ ┌─┘ ┌─┘ │ └─┐ ──┬───┤ │ │ │ ┌─┤
│ │     │ │ │   │   │   │   │   │   │   │ │
│ └── │ ├─┘ │ ──┤ ──┤ │ ├─┐ │ │ ├───┴───┘ │
│     │ │   │   │   │ │ │ │   │ │         │
├─────┘ │ ┌─┘ │ └── └─┘ │ └───┘ └────── │ │
│         │   │         │               │ 
└─────────┴───┴─────────┴───────────────┴──