──┬───────┬─────┬─────────────┬───────┬───┐
  │       │     │             │       │   │
│ │ ──┬── │ ┌── │ ────┬───┬── │ ┌──── └─┐ │
│ │   │   │ │   │     │   │   │ │       │ │
│ └── │ ──┘ │ ┌─┘ ──┐ │ │ │ ┌─┘ ├───┬── │ │
│     │     │ │     │   │ │ │   │   │     │
├───┬─┴─────┤ │ ──┬─┴───┘ │ └─┐ │ │ └─┬── │
│   │       │ │   │       │   │   │   │   │
│ │ │ │ ──┐ │ └───┤ ┌─────┴─┐ └───┴── │ ──┤
│ │ │ │   │ │     │ │       │         │   │
│ │ │ └─┐ │ └───┐ │ └───┐ ──┴─┬───────┴─┐ │
│ │     │ │     │ │     │     │         │ │
├─┴─┐ ┌─┘ ├── ┌─┘ │ ┌── │ ──┐ │ ┌─┬── │ │ │
│   │ │   │   │   │ │   │   │   │ │   │ │ │
│ │ └─┘ ┌─┘ ──┤ ──┴─┤ ──┴─┐ └───┤ │ ──┴─┤ │
│ │     │     │     │     │     │ │     │ │
│ └───┬─┘ ┌───┼──── │ ┌── ├─┬── │ └─┬── │ │
│     │   │   │     │ │   │ │   │   │   │ │
│ ──┐ └───┘ │ │ ────┴─┘ ┌─┘ │ ──┴── │ ──┘ │
│   │       │           │           │     
└───┴───────┴───────────┴───────────┴──────