────┬─────────┬─┬───────┬───────────┬─────┐
    │         │ │       │           │     │
┌─┐ └────── │ │ │ │ ┌── │ ┌── ┌───┐ └─┐ ──┤
│ │         │ │ │ │ │   │ │   │   │   │   │
│ ├───┬─────┘ │ │ │ │ ┌─┴─┘ ┌─┴── └─┐ └─┐ │
│ │   │       │   │ │ │     │       │   │ │
│ │ │ │ ──┬───┤ ──┤ │ └── ┌─┘ ┌──── ├── │ │
│ │ │ │   │   │   │ │     │   │     │   │ │
│ │ │ └─┐ └─┐ └── │ ├─────┴── ├───┐ │ ──┘ │
│   │   │   │     │ │         │   │ │     │
│ ──┴─┐ ├── │ ┌───┤ └───┐ ┌── │ │ └─┼───┐ │
│     │ │   │ │   │     │ │   │ │   │   │ │
├── ┌─┘ │ ┌─┘ │ │ │ ──┐ │ ├───┘ ├── │ │ │ │
│   │   │ │   │ │ │   │ │ │     │   │ │ │ │
│ ──┤ ──┤ └───┘ │ │ ┌─┘ │ │ ──┬─┤ ┌─┘ │ │ │
│   │   │       │ │ │   │ │   │ │ │   │ │ │
├── ├─┐ └───┬───┤ └─┘ ┌─┘ └─┐ │ │ │ ┌─┤ │ │
│   │ │     │   │     │     │ │ │   │ │   │
│ ──┘ └───┐ │ │ └─────┘ ──┐ │ │ └───┘ └───┘
│         │   │           │               
└─────────┴───┴───────────┴────────────────