──┬─────────────────┬─────────┬───────────┐
  │                 │         │           │
│ │ ┌─┬────── ┌──── │ ┌──── │ └───┐ ┌── │ │
│ │ │ │       │     │ │     │     │ │   │ │
│ │ │ │ ┌─┬───┤ ──┬─┘ │ ┌───┴───┐ └─┘ ┌─┤ │
│ │   │ │ │   │   │   │ │       │     │ │ │
│ └───┘ │ │ │ ├── │ ┌─┤ └───┐ │ ├─────┤ │ │
│       │   │ │   │ │ │     │ │ │     │   │
├─────┬─┘ ┌─┤ │ ┌─┤ │ └─┬── │ ├─┘ ┌─┐ │ ┌─┤
│     │   │ │   │ │     │   │ │   │ │   │ │
│ │ │ │ ──┤ └───┤ └─┐ ┌─┘ ┌─┘ │ ┌─┘ └───┘ │
│ │ │ │   │     │   │ │   │     │         │
│ │ │ └─┐ └─┐ ──┤ │ │ │ ──┤ ──┬─┴───┐ │ ──┤
│ │ │   │   │   │ │   │   │   │     │ │   │
│ │ ├───┴── │ │ │ └───┴─┐ └─┐ └── │ │ ├── │
│ │ │       │ │         │   │     │ │ │   │
│ │ │ ┌───┬─┘ ├───┬─────┴── ├─────┤ │ │ │ │
│ │   │   │   │   │         │     │ │ │ │ │
│ └───┘ │ └───┘ │ │ ┌───────┘ │ ──┘ └─┘ │ │
│       │       │   │         │         │  
└───────┴───────┴───┴─────────┴─────────┴──